11111111111111111111111111
1P01000CC00C1100011C000001
10000111110011000011111001
100011C000000000000C000001
1001000CC00C1100011C000001
10000111110011000011111001
1E0011C000001100011C000001
11111111111111111111111111