1111111111111111111
1000000000000000001
1000C00000000000001
1000000000000000001
100000000000000C001
1000000000C00000001
1000000000000000001
1000000000000000001
1000000000000000001
1000000000E00000001
1000000000100000001
1000000000000000001
1000000111100000001
1000000100000000001
10000001C0100000001
1000000111100000001
1000000000000000001
1P00000000000000001
1111111111111111111
