1111111111
111E000000
111P111C11