1111000111
111E000111
111P000C11