1111111111111
1001000C000C1
1100011111001
1P1011E100001
1111111111111
